12,7
1,1,1,1,1,1,1,1,1,1,1,1
1,200,0,0,0,0,0,202,0,0,0,1
1,1,1,1,1,1,0,1,1,1,0,1
1,0,0,0,0,0,0,203,0,0,0,1
1,0,1,1,1,1,1,1,1,1,1,1
1,0,0,0,204,0,0,0,0,0,201,1
1,1,1,1,1,1,1,1,1,1,1,1
