12,5
1,1,1,1,1,1,1,1,1,1,1,1
1,200,0,204,0,0,202,0,0,206,0,1
1,1,1,1,1,1,1,1,1,1,0,1
1,201,0,205,0,0,203,0,0,207,0,1
1,1,1,1,1,1,1,1,1,1,1,1
